################################################################################
#,,,,,,,#,,,,,,,,,,##,,,,,,,#,,,,,,,,,,##,,,,,,,#,,,,,,,,,,##,,,,,,,#,,,,,,,,,,#
#,,,,,,,#,#####,,,,#,,,,,,,,,,,####,,,,##,,,,,,,#,,####,,,,##,,,,,,,#,#####,,,,#
#,,,,,,,#,#,,,,,,,,#,,,,,,,,,,,,,,,,,,,##,,,,,,,#,,,,,,,,,,##,,,,,,,#,#,,,,,,,,#
#,,,,,,,#,#,,,,,,,,#,,,,,,,,,,,,,,,,,,,##,,,,,,,#,,,,,,,,,,##,,,,,,,#,#,,,,,,,,#
#,,,,,,,,,#,,,,,,,,##,,,,,,,,,#,,,,,,,,##,,,,,,,,,#,,,,,,,,##,,,,,,,,,#,,,,,,,,#
#,,,,,,,,,#,,,,,,,,##,,,,,,,,,#,,,,,,,,##,,,,,,,,,#,,,,,,,,##,,,,,,,,,#,,,,,,,,#
#,,,,,,,,,#,,,,,,,,##,,,,,,,,,#,,,,,,,,##,,,,,,,,,#,,,,,,,,##,,,,,,,,,#,,,,,,,,#
#,,,,,,,,,,,,,,,,,,##,,,,,,,,,,,,,,,,,,##,,,,,,,,,,,,,,,,,,##,,,,,,,,,,,,,,,,,,#
#,,,,,,,,,,,,,,,,,,##,,,,,,,,,,,,,,,,,,##,,,,,,,,,,,,,,,,,,##,,,,,,,,,,,,,,,,,,#
################################################################################
################################################################################
#,,,,,,,#,,,,,,,,,,##,,,,,,,#,,,,,,,,,,##,,,,,,,#,,,,,,,,,,##,,,,,,,#,,,,,,,,,,#
#,,,,,,,#,#####,,,,##,,,,,,,#,#####,,,,##,,,,,,,#,#####,,,,##,,,,,,,#,#####,,,,#
#,,,,,,,#,#,,,,,,,,##,,,,,,,#,#,,,,,,,,##,,,,,,,#,#,,,,,,,,##,,,,,,,#,#,,,,,,,,#
#,,,,,,,#,#,,,,,,,,##,,,,,,,#,#,,,,,,,,##,,,,,,,#,#,,,,,,,,##,,,,,,,#,#,,,,,,,,#
#,,,,,,,,,#,,,,,,,,##,,,,,,,,,#,,,,,,,,##,,,,,,,,,#,,,,,,,,##,,,,,,,,,#,,,,,,,,#
#,,,,,,,,,#,,,,,,,,##,,,,,,,,,#,,,,,,,,##,,,,,,,,,#,,,,,,,,##,,,,,,,,,#,,,,,,,,#
#,,,,,,,,,#,,,,,,,,##,,,,,,,,,#,,,,,,,,##,,,,,,,,,#,,,,,,,,##,,,,,,,,,#,,,,,,,,#
#,,,,,,,,,,,,,,,,,,##,,,,,,,,,,,,,,,,,,##,,,,,,,,,,,,,,,,,,##,,,,,,,,,,,,,,,,,,#
#,,,,,,,,,,,,,,,,,,##,,,,,,,,,,,,,,,,,,##,,,,,,,,,,,,,,,,,,##,,,,,,,,,,,,,,,,,,#
################################################################################
################################################################################
#,,,,,,,#,,,,,,,,,,##,,,,,,,#,,,,,,,,,,##,,,,,,,#,,,,,,,,,,##,,,,,,,#,,,,,,,,,,#
#,,,,,,,#,#####,,,,##,,,,,,,#,#####,,,,##,,,,,,,#,#####,,,,##,,,,,,,#,#####,,,,#
#,,,,,,,#,#,,,,,,,,##,,,,,,,#,#,,,,,,,,##,,,,,,,#,#,,,,,,,,##,,,,,,,#,#,,,,,,,,#
#,,,,,,,#,#,,,,,,,,##,,,,,,,#,#,,,,,,,,##,,,,,,,#,#,,,,,,,,##,,,,,,,#,#,,,,,,,,#
#,,,,,,,,,#,,,,,,,,##,,,,,,,,,#,,,,,,,,##,,,,,,,,,#,,,,,,,,##,,,,,,,,,#,,,,,,,,#
#,,,,,,,,,#,,,,,,,,##,,,,,,,,,#,,,,,,,,##,,,,,,,,,#,,,,,,,,##,,,,,,,,,#,,,,,,,,#
#,,,,,,,,,#,,,,,,,,##,,,,,,,,,#,,,,,,,,##,,,,,,,,,#,,,,,,,,##,,,,,,,,,#,,,,,,,,#
#,,,,,,,,,,,,,,,,,,##,,,,,,,,,,,,,,,,,,##,,,,,,,,,,,,,,,,,,##,,,,,,,,,,,,,,,,,,#
#,,,,,,,,,,,,,,,,,,##,,,,,,,,,,,,,,,,,,##,,,,,,,,,,,,,,,,,,##,,,,,,,,,,,,,,,,,,#
################################################################################
################################################################################
#,,,,,,,#,,,,,,,,,,##,,,,,,,#,,,,,,,,,,##,,,,,,,#,,,,,,,,,,##,,,,,,,#,,,,,,,,,,#
#,,,,,,,#,#####,,,,##,,,,,,,#,#####,,,,##,,,,,,,#,#####,,,,##,,,,,,,#,#####,,,,#
#,,,,,,,#,#,,,,,,,,##,,,,,,,#,#,,,,,,,,##,,,,,,,#,#,,,,,,,,##,,,,,,,#,#,,,,,,,,#
#,,,,,,,#,#,,,,,,,,##,,,,,,,#,#,,,,,,,,##,,,,,,,#,#,,,,,,,,##,,,,,,,#,#,,,,,,,,#
#,,,,,,,,,#,,,,,,,,##,,,,,,,,,#,,,,,,,,##,,,,,,,,,#,,,,,,,,##,,,,,,,,,#,,,,,,,,#
#,,,,,,,,,#,,,,,,,,##,,,,,,,,,#,,,,,,,,##,,,,,,,,,#,,,,,,,,##,,,,,,,,,#,,,,,,,,#
#,,,,,,,,,#,,,,,,,,##,,,,,,,,,#,,,,,,,,##,,,,,,,,,#,,,,,,,,##,,,,,,,,,#,,,,,,,,#
#,,,,,,,,,,,,,,,,,,##,,,,,,,,,,,,,,,,,,##,,,,,,,,,,,,,,,,,,##,,,,,,,,,,,,,,,,,,#
#,,,,,,,,,,,,,,,,,,##,,,,,,,,,,,,,,,,,,##,,,,,,,,,,,,,,,,,,##,,,,,,,,,,,,,,,,,,#
################################################################################
################################################################################
#,,,,,,,#,,,,,,,,,,##,,,,,,,#,,,,,,,,,,##,,,,,,,#,,,,,,,,,,##,,,,,,,#,,,,,,,,,,#
#,,,,,,,#,#####,,,,##,,,,,,,#,#####,,,,##,,,,,,,#,#####,,,,##,,,,,,,#,#####,,,,#
#,,,,,,,#,#,,,,,,,,##,,,,,,,#,#,,,,,,,,##,,,,,,,#,#,,,,,,,,##,,,,,,,#,#,,,,,,,,#
#,,,,,,,#,#,,,,,,,,##,,,,,,,#,#,,,,,,,,##,,,,,,,#,#,,,,,,,,##,,,,,,,#,#,,,,,,,,#
#,,,,,,,,,#,,,,,,,,##,,,,,,,,,#,,,,,,,,##,,,,,,,,,#,,,,,,,,##,,,,,,,,,#,,,,,,,,#
#,,,,,,,,,#,,,,,,,,##,,,,,,,,,#,,,,,,,,##,,,,,,,,,#,,,,,,,,##,,,,,,,,,#,,,,,,,,#
#,,,,,,,,,#,,,,,,,,##,,,,,,,,,#,,,,,,,,##,,,,,,,,,#,,,,,,,,##,,,,,,,,,#,,,,,,,,#
#,,,,,,,,,,,,,,,,,,##,,,,,,,,,,,,,,,,,,##,,,,,,,,,,,,,,,,,,##,,,,,,,,,,,,,,,,,,#
#,,,,,,,,,,,,,,,,,,##,,,,,,,,,,,,,,,,,,##,,,,,,,,,,,,,,,,,,##,,,,,,,,,,,,,,,,,,#
################################################################################
################################################################################
#,,,,,,,#,,,,,,,,,,##,,,,,,,#,,,,,,,,,,##,,,,,,,#,,,,,,,,,,##,,,,,,,#,,,,,,,,,,#
#,,,,,,,#,#####,,,,##,,,,,,,#,#####,,,,##,,,,,,,#,#####,,,,##,,,,,,,#,#####,,,,#
#,,,,,,,#,#,,,,,,,,##,,,,,,,#,#,,,,,,,,##,,,,,,,#,#,,,,,,,,##,,,,,,,#,#,,,,,,,,#
#,,,,,,,#,#,,,,,,,,##,,,,,,,#,#,,,,,,,,##,,,,,,,#,#,,,,,,,,##,,,,,,,#,#,,,,,,,,#
#,,,,,,,,,#,,,,,,,,##,,,,,,,,,#,,,,,,,,##,,,,,,,,,#,,,,,,,,##,,,,,,,,,#,,,,,,,,#